11111111111111111111111111111
100100000000C000000000000C1C1
1C000111111001010100000000001
1P0011E00000C100000100X000001
11111111111111111111111111111
