11111111111111
100100000100C1
10000111111001
1P0011E0000001
11111111111111