111111111111111
100100000000C11
1C0001111110011
1P0011E00000C11
111111111111111