111111111111111111111111
100100000000C00000000001
1C0001111110010101000001
1P0011E00000C10000010001
111111111111111111111111
